##############################
#............................#
#.@..........................#
####.........................#
###..........................#
##...........................#
#............................#
#............................#
#..#.........................#
#..#.........................#
#..####..#..#..###...........#
#..#..#..#..#..#..#..........#
#..#..#..#..#..####..........#
#..####...###..#.............#
#...........#...###..........#
#........#..#................#
#.........##.................#
#............................#
#............................#
#............................#
#............................#
##############################

{
  "name": "Bye…",
  "baseLife": 2
}

