++++++++++++++++++++++++++++++
++++++++++++++++++++++++++++++
++..........................++
++..........................++
++..........................++
++..........................++
++..........................++
##..........................##
##.......................#..##
##.....#.................#..##
##.....#.....#..#..###...#..##
##..*..#.....#.*#..#..#..#..##
##.....####..#..#..####..#..##
##.....#..#...###..#*.......##
##.....#..#.....#..#.....*..##
##.....####..#..#...###..*..##
##.....*......##............##
##..................*.......##
##..........................##
##..............@...........##
##############################
##############################

{
  "name": "Thank you for playing!",
  "baseLife": 1,
  "music": "musicBye",
  "hint": "Made by Shawn M Moore (@sartak)",
  "hint2": "for Ludum Dare 44",
  "hint3": "\"Your life is currency\"",
  "badgeBirdie": true
}

