##############################
##############################
##..........................##
##..........................##
##..........................##
##......B..........##.......##
###########.....b..##.......##
#####################.......##
##.........##########.......##
##.@............vvvvv.......##
######......................##
######......................##
####........................##
####.....................^..##
####....................<#..##
##...................^^^.#..##
##..........##############..##
##..........##############..##
##.....###################..##
##.....###################..##
##########################..##
##########################++##

{
  "name": "Like ein Glöve",
  "baseLife": 2
}

