##############################
##############################
##..........................##
##..........................##
##..........................##
##..........................##
##..........................##
##..........................##
##..........................##
##..........................##
##..........................##
##.@...............a........##
######...........########...##
##....##.......#######..#...##
##.....#.......#........#...##
##.....#########........#...##
##......................#...##
##......................#...##
##......................#....+
##......................#....+
##############################
##############################

{
  "name": "TODO",
  "baseLife": 3
}

