##############################
##############################
##..........................##
##..........................##
##..........................##
##..........................##
##..........................##
##..........................##
##..........................##
##...........................+
##...........................+
##........................####
##........................####
##......................######
##....................########
##....##..............########
##....##..............########
##...##...............########
##...##...............########
##.@.##^^^^^^^^^^^^^^^########
##############################
##############################

{
  "name": "Leap of faith",
  "baseLife": 3
}
