##############################
##############################
##..........................##
##..........................##
##..........................##
##..........................##
##..........................##
##..........................##
##..........................++
##..........................++
##........................####
##........................####
##........................####
##........................####
##...##...............########
##...##...............########
##...##...............########
##...##...............########
##...##...............########
##.@.##^^^^^^^^^^^^^^^########
##############################
##############################

{
  "name": "Chomp chomp",
  "baseLife": ""
}
