##############################
##############################
##..........................##
##..........................##
##..........................##
##...........................+
##...........................+
##.....##############..#######
##.....##############..#######
#####.......................##
#####.......................##
#####.......................##
#####################....___##
#########0##0########.......##
#####################...___.##
##......vvvvvv..............##
##.....................___..##
##..........................##
##....................___...##
##..@...^^^^^^..............##
##############################
##############################

{
  "name": "Chomp chomp",
  "baseLife": 3
}
