##############################
##############################
##.......................##.##
##.......................##.##
##...<##.................vv.##
##...<##....................##
##..........................##
##...................##.....##
##...................##.....##
##...................##.....##
##...................##.....##
##...........##......##.....##
##...........##......##.....##
##..##.......##......vv.....##
##..##.......##.............++
##..vv.......vv.............++
##........................####
##......^^................####
##......##..............######
##.@....##......^^^^^^^^######
##############################
##############################

{
  "name": "Like ein Glove",
  "baseLife": 2
}

