##############################
##############################
##..........................##
##..........................##
##..........................##
##..........................##
##..........................##
##..........................##
##..........................##
##..........................##
##..........................##
##..........................##
##...................###....##
##..................<#......##
##..................<#......##
##..................<#......##
##..................<##.....##
##.......##..........###....##
##.......##..........####....+
##.@.....##^^^^^^^^^^#####...+
##############################
##############################

{
  "name": "Even leaper of faith",
  "baseLife": 2
}
