##############################
##############################
##..........................##
##..........................##
##..........................##
##..................#####...##
##..................#...#...##
##................*.#...#...##
##..................#...#...##
##..................#...#...##
##..................#...#...##
##.@................#...#...##
######..............#...#...##
##...#..............#...#...##
##...#..b.........A.#...#...##
##...#####.......####...#...##
##.......#...#####..#...#...##
##.......#####......#...#...##
##..................#...#....+
##..................#...#....+
##############################
##############################

{
  "name": "Buy one, get one free",
  "baseLife": 2
}

