##############################
##############################
##..........................##
##.*........................##
##....................*.....##
##.@........................##
######...............###....##
##..........................##
##..........................##
##...........................+
##...........................+
##........................####
##........................####
##......................__####
##........................####
##.........##.........########
##.......####.........########
##.......####.........########
##.....######.........########
##.....######^^^^^^^^^########
##############################
##############################

{
  "name": "Leap of faith",
  "music": "musicWorld1",
  "badgeBirdie": true
}
