##############################
##############################
##.......................##.##
##.......................##.##
##...<##.................vv.##
##...<##..............##....##
##....................##....##
##....................##....##
##....................##....##
##............*.......##....##
##....................vv.....+
##...........##..............+
##...........##...........__##
##...##......vv.............##
##...##.....................##
##...##...................####
##...##...................####
##...vv.................######
##......*.^^..........########
##.@......##....^^^^^^########
##############################
##############################

{
  "name": "It's a sticky situation",
  "music": "musicWorld2",
  "baseLife": 1,
  "birdieBadge": true
}

