#####++#######################
#####..#######################
##..........................##
##..........................##
##.______...................##
##..........................##
##################__________##
##..........................##
##..........................##
##.@..................______##
##..........................##
##..........................##
##........................*.##
##########..................##
##..................________##
##..........................##
##..........................##
##.....#________#...........##
##.....#........#...........##
##.....#........#...........##
##############################
##############################

{
  "name": "Up and away!",
  "baseLife": 1
}
