##############################
##############################
##.................##>......##
##.................##>......##
##.................##>......##
##.................##>......##
##.................##>......##
#####################>......##
#####################>......##
##vvvvvvvvvvvvvvvvvvv.......##
##..........................##
##..........................##
##.......................^..##
##......................<#..##
##......................<#..##
##..............^^^^^^^^.#..##
##....####################..##
##....####################..##
##....####################++##
##..@.####################++##
##############################
##############################

{
  "name": "Like ein Glove",
  "baseLife": 2
}

