##############################
##############################
##..........................##
##..*.......................##
##..........................##
##....B.....................##
############}...............##
#############...b...........##
####################}.......##
##........###########.......##
##.@............vvvvv.......##
######......................##
######......................##
####.....................^..##
####....................<#..##
##...................^^^.#..##
##..........##############..##
##..*.......##############..##
##.....###################..##
##.....###################..##
##########################..##
##########################++##

{
  "name": "Like ein Glöve",
  "music": "musicWorld1",
  "badgeBirdie": true,
  "badgeKiller": true
}

