#####++#######################
#####..#######################
##..........................##
##..........................##
##.______...................##
##..........................##
###############_____________##
##..........................##
##..........................##
##.@..................______##
##..........................##
##..........................##
##........................*.##
#######.....................##
##..................________##
##..........................##
##..........................##
##________________#.........##
##................#.........##
##................#.........##
##############################
##############################

{
  "name": "Up, up, and away!",
  "music": "musicWorld1"
}
