##############################
##############################
##....#.....................##
##....#.....................##
##.@..#.....................##
####..#.....................##
##....#.....................##
##....#.....................##
##....#??????????????........+
##..................?........+
##.................<##########
##.................<##########
##.................<##########
##.................<##########
##.................<##########
##.................<##########
##...............#############
##...............#############
##............################
##............################
##############################
##############################

{
  "name": "Double Jump!!",
  "baseLife": 3,
  "hint": "Hold [UP] and press [JUMP]! But . . .",
  "hintXMod": 60
}
