##############################
##############################
##..........................##
##..........................##
##..........................##
##..........................++
##..........................++
##.....##############..#######
##.....##############..#######
####........................##
####........................##
####........................##
#####################.....####
#########0###0#######.....####
#####################...##..##
##.....vvvvvvvvv........##..##
##....................##....##
##....................##....##
##..................##......##
##.@...^^^^^^^^^....##......##
##############################
##############################

{
  "name": "Chomp chomp",
  "baseLife": 3
}
