##############################
##############################
##..........................##
##..........................##
##..........................##
##...........................+
##...........................+
##.....##############..#######
##.....##############..#######
####........................##
####........................##
####........................##
#####################.....####
#########0##0########.....####
#####################...##..##
##......vvvvvv..........##..##
##....................##....##
##....................##....##
##..................##......##
##.@....^^^^^^......##......##
##############################
##############################

{
  "name": "Chomp chomp",
  "baseLife": 3
}
