##############################
##############################
##..........................##
##..*.......................##
##..........................##
##......B...................##
###########.....b...........##
#####################.......##
##.........##########.......##
##.@............vvvvv.......##
######......................##
######......................##
####........................##
####.....................^..##
####....................<#..##
##...................^^^.#..##
##..........##############..##
##..*.......##############..##
##.....###################..##
##.....###################..##
##########################..##
##########################++##

{
  "name": "Like ein Glöve",
  "music": "musicWorld1",
  "baseLife": 1,
  "badgeBirdie": true,
  "badgeKiller": true
}

