##############################
##############################
##.......................##.##
##.......................##.##
##...<##.................vv.##
##...<##.............##.....##
##...................##.....##
##...................##.....##
##...................##.....##
##...................##.....##
##...................vv.....##
##...........##.............##
##...........##.............##
##..##.......##.............##
##..##.......##..............+
##..vv.......vv..............+
##........................####
##......^^................####
##......##..............######
##.@....##......^^^^^^^^######
##############################
##############################

{
  "name": "It's a sticky situation",
  "baseLife": 3
}

