##############################
##############################
##..........................##
##........................@.##
##..........................##
##...#####...[[[[[..........##
##...#......................##
##...#..............._______##
##...#......................##
##...#.........###############
##...##########.............##
##..........................##
##..........................##
##_____.....................##
##..........................##
##..........................##
##......]]]]]...............##
##................[[[[[......+
##...........................+
##^^^^^^^^^^^^^^^^^^^^^^^#####
##############################
##############################

{
  "name": "Moving on without you",
  "baseLife": 2
}

