##############################
##############################
##..........................##
##..........................##
##..........................##
##..........................##
##..........................##
##..........................##
##......??????????...........+
##...............?...........+
##..............<#############
##..............<#############
##..............<#############
##..............<#############
##..............<#############
##..............<#############
##.........<##################
##.........<##################
##.........<##################
##.@.......<##################
##############################
##############################

{
  "name": "Double Jump",
  "baseLife": 3,
  "hint": "Press [UP] and [JUMP] to double-jump! but…"
}
