##############################
##############################
##..........................##
##..........................##
##..........................##
##..........................##
##..........................##
##..........................##
##..........................##
##..........................##
##..........................##
##..........................##
##..........................##
##..........................##
##..........................##
##..........................##
##..........................##
##..........................##
##.......................++.##
##.@.......^^^^^^^^......++.##
##############################
##############################

{
  "name": "Double Jump",
  "baseLife": 2,
  "hint": "Press [UP] and [JUMP] to Double Jump! but…"
}
