##############################
#............................#
#............................#
#............................#
#............................#
#...#....#....#....#.#.......#
#...#....#.........#.#.......#
#...#....#....#....#.#.......#
#...######....#....#.#.......#
#...#....#....#....#.#.......#
#...#....#....#..............#
#...#....#....#....#.#.......#
#............................#
#............................#
#............................#
#............................#
#............................#
#............................#
#............................#
#............................#
#............................#
##############################

{
  "name": "Hello!"
}

