##############################
#............................+
#............................+
#.........................####
#..........................###
#...........................##
#............................#
#............................#
#............................#
#............................#
#............................#
#...#....#....#....#.#.......#
#...#....#.........#.#.......#
#...#....#....#....#.#.......#
#...######....#....#.#.......#
#...#....#....#....#.#.......#
#...#....#....#..............#
#...#....#....#....#.#.......#
#............................#
#............................#
#.@..........................#
##############################

{
  "name": "Hello!"
}

