##############################
##############################
##...........................+
##...........................+
##..........................##
##........................####
##....................#####.##
##....................#.....##
##....................#.....##
##...............######.....##
##...............#..........##
##...............#..........##
##............####..........##
##????????????#.............##
##.........####.............##
##.........#................##
##......####................##
##......#...................##
##...####...................##
##.@.####...................##
##############################
##############################

{
  "name": "Hello!",
  "baseLife": 2,
  "hint": "Press [Z] to jump!"
}

