##############################
##############################
##..........................++
##..........................++
##........................####
##........................####
##.....................#######
##.....................#######
##..................##########
##..................##########
##...............#############
##...............#############
##............################
##............################
##.........###################
##.........###################
##......######################
##......######################
##...#########################
##.@.#########################
##############################
##############################

{
  "name": "Hello!"
}

