##############################
##############################
##..........................++
##..........................++
##.......................#####
##.......................#####
##....................########
##....................########
##.................###########
##.................###########
##..............##############
##..............##############
##...........#################
##...........#################
##........####################
##........####################
##.....#######################
##.....#######################
##...#########################
##.@.#########################
##############################
##############################

{
  "name": "Hello!"
}

