##############################
##############################
##..........................++
##..............a...........++
##________________________####
##........................####
##.....................#######
##......a..............#######
##....[[[[..........##########
##..................##########
##.........*.....#############
##...............#############
##............################
##............################
##.........###################
##.......A.###################
##......######################
##......######################
##...#########################
##.@.#########################
##############################
##############################

{
  "name": "Stairs",
  "baseLife": 2
}

