#############++###############
#############..###############
##.........#................##
##.....*...#................##
##.........########_________##
##...#######................##
##.........#..............<###
##.........#...........*..<###
##...#######..............<###
##.........#....^^^^^^^^^^.###
##.........###..##############
##........................*.##
##..........................##
##...#########################
##..........................##
##..........................##
##...####################...##
##..........................##
##..........................##
##.@.....................#####
##############################
##############################

{
  "name": "It's the last one",
  "baseLife": 1,
  "badgeBirdie": true
}

