##############################
##############################
##...................<#.....##
##.*.................<#.....##
##...................<#.....##
##.@.................<########
#####^^^^^^^...........vvvvv##
##...#######^^^^............##
##..........####^...........##
##..............#>..........##
##..............#>..........##
##..............#>..........##
##..............#>.........<##
##..............#>.........<##
##..............#>.........<##
##..............#>.........<##
##..............#>..........##
##..............#>..........##
##..............#>...........+
##..............#.^^^^^......+
##############################
##############################

{
  "name": "Sure hope this works …",
  "music": "musicWorld3"
}

