#########################++###
#########################..###
##...........#0#0#.......*..##
##...........#####..........##
##....@......#####..........##
##...#####...#0#0#...*......##
##...#0#0#...#####..........##
##...#####...#####..........##
##...........#0#0#.......*..##
##.....A.....#####..........##
##..#######..#####.*........##
##..vvvvvvv..#0#0#..........##
##...........#####......*...##
##...........#####..........##
##..^^^^^^^..#0#0#..........##
##..#######..#####..........##
##...........#####.*........##
##..........................##
##..........................##
##.....................b....##
##############################
##############################

{
  "name": "Ever higher",
  "baseLife": 1
}

