##############################
##############################
##..........................##
##..........................##
##..........................##
##..........................##
##..........................##
##..........................##
##..........................##
##..........................##
##..........................##
##..........................##
##..........................##
############...._______.....##
##vvvvvvvvvv.................+
##...........................+
##..............*........#####
##.*.....................#####
##.......................#####
##.@..^^^^^^^^^^^^^^^^^^^#####
##############################
##############################

{
  "name": "The ole one, two, jump!",
  "baseLife": 1
}

