##############################
##############################
##..........................##
##..........................##
##..........................##
##..........................##
##......##...##.............##
##......##...##.............##
##......#######.............##
##......#######.............##
##......vvvvvvv.............##
##..........................##
##..........................##
##..........................##
##..........................##
##......^^^^^^^.............##
##......#######.............##
##......#######.............##
##......##...##..............+
##.@....##...##..............+
##############################
##############################

{
  "name": "Wall Jump",
  "baseLife": 2
}

