##############################
##############################
##...#......................##
##.@.#......................##
##.###......................##
##..........................##
##.................#........##
##.................#........##
##..............####........##
##..........................##
##^^^^^^^^^^^^^^^^^^........##
####################........##
##..........................##
##..........................##
##..........................##
##..........................##
##..........................##
##................#>.......<##
##................#>.......<##
##................#.^^^^^^^.##
##############..##############
##############++##############

{
  "name": "Catch!",
  "baseLife": 3
}


