##############################
##############################
##..........................##
##......................*...##
##.................B........##
##...............(]]])......##
##..........................##
##......######################
##......#...................##
##...####A..................##
##......###.................##
##........#.................##
##._____..#..*..............##
##........#.......^^^^^^^^..##
##.......*#......<########..##
######....#......<#.........##
##........#......<#.........##
##.......##......<#.........##
##.............@.<#..*......##
#####.........#####.........##
##########################..##
##########################++##

{
  "name": "Flip it and reverse it",
  "music": "musicWorld2",
  "badgeBirdie": true,
  "badgeKiller": true,
  "facingLeft": true
}

