##############################
##############################
##........#.......#.........##
##........#...@...#.........##
##........#..###..#.........##
##........#.......#..........+
###########.......#..........+
##vvvvvvvv#.......#......___##
##................#.........##
##................#.........##
##................#.........##
##................#.........##
##........^^^^^^^^#.........##
##........#########.........##
##..........................##
##..........................##
##.....................#######
##.....................#....##
##.................#####....##
##^^^^^^^^^........#........##
##############################
##############################

{
  "name": "Ping pong",
  "baseLife": 4
}

