##################++##########
##################..##########
##.........#................##
##.........#................##
##.........#................##
############...._______.....##
##vvvvvvvvvv................##
##..........................##
##..............*...........##
##.*........................##
##..........................##
##____^^^^^^^^^^^^^^^^^^^^^^##
##....########################
##..........................##
##..........................##
##..............*...........##
##..........................##
##..........................##
##...........b.....a......@.##
##.....A....{#}...###...######
##############################
##############################

{
  "name": "The ole one, two, jump!",
  "music": "musicWorld2",
  "badgeKiller": true,
  "facingLeft": true
}

