##############################
##############################
##..........................##
##..........................##
##..........................##
##..........................##
##..........................##
##..........................##
##..........................##
##..........................##
##..........................##
##..........................##
####################........##
##....vvvvvvvvvvvvvv........##
##..........................++
##..........................++
##.......................#####
##.......................#####
##.......................#####
##.@..^^^^^^^^^^^^^^^^^^^#####
##############################
##############################

{
  "name": "Wall Jump",
  "baseLife": 3
}

