##############################
##############################
##..........................##
##..........................##
##..........................##
##..........................##
##..........................##
##.............#########????##
##.@...........#............##
######.........#............##
##...#.........#............##
##...###.......#............##
##.....#.......#............##
##.....#.....###............##
##..##########..............##
##..........................##
##...............#############
+................#..........##
+................#..........##
###..............#######....##
###^^^^^^^^^^^################
##############################

{
  "name": "Wall jump!!",
  "baseLife": 6,
  "hint": "Drag into a wall in the air and [JUMP]",
  "hintYPosition": 0.77
}

