##############################
##############################
##..........................##
##..........................##
##..........................##
##..........................##
##..........................##
##..........................##
##..........................##
############................##
##.........#................##
##.........#................##
##.........#................##
##.........#................##
##.........#......^^^^^^^^..##
##.@.......#.....<########..##
######...###.....<#.........##
##...............<#.........##
##...............<#.........##
##...............<#.........##
##########################..##
##########################++##

{
  "name": "Take it and flip it",
  "baseLife": 3
}

