##############################
##############################
##......#...................##
##....*.#...................##
##.@....#...................##
##.######...................##
##...............*.#........##
##.................#........##
##..............####........##
##..........................##
##^^^^^^^^^^^^^^^^^^........##
####################........##
##..........................##
##..........................##
##..........................##
##..........................##
##..........................##
##................#>.......<##
##................#>.......<##
##.....A..........#.^^^^^^^.##
##############..##############
##############++##############

{
  "name": "Catch!",
  "music": "musicWorld2",
  "badgeBirdie": true,
  "badgeKiller": true
}

