##############################
##############################
##...........#...............+
##...........#*..............+
##....*......#.............<##
##.@.......................<##
#####......................<##
##>...........*............<##
##>........................<##
##>........................<##
##>........................<##
##>.................^^.....<##
##>.................<>.....<##
##>..........^^.....<>.....<##
##>..........<>.....vv.....<##
##>..........<>............<##
##>..........vv............<##
##>........................<##
##>........................<##
##0^^^^^^^^^^^^^^^^^^^^^^^^0##
##############################
##############################

{
  "name": "The faithiest of leaps",
  "music": "musicWorld3",
  "baseLife": 1
}
