##############################
##############################
##............vvvvvvvvvvvvvv##
##..........................##
##...####...................##
##.....##...................##
##.....##....................+
##.....##..^^^^^^^^^^^.......+
###....#######################
###....#######################
####.........?..........##.<##
####.........?..........##.<##
#######......?..........##.<##
#####################......<##
##..........vvvvvvvv##.....<##
##...................##....<##
##....................#....<##
##....................##...<##
##.........................<##
##.@..^^^^^^^^.............<##
##############################
##############################

{
  "name": "Skill get!!",
  "baseLife": 3,
  "hint": "Press against a wall in the air and [JUMP]"
}

