##############################
##############################
##................<#........##
##................<#........##
##.*..............<#........##
##............<#..<#....*...##
##.@..........<#............##
#####.........<#............##
##............<#.......###..##
##............<#.*..........##
##^^^^^^^^^^^^.#............##
##################..........##
##........#>..vvvv..........##
##........#>................##
##........#>................##
##........#>................##
##........#>..........^^^...##
##.................^^^###^^^##
##..............^^^###...#####
##..............###.........##
####..########################
####++########################

{
  "name": "Windmill of spikey death",
  "music": "musicWorld3",
  "baseLife": 1,
  "badgeBirdie": true
}


