##############################
##############################
##........#.......#.........##
##........#...@...#.........##
##........#..###..#.........##
##........#...*...#..........+
###########.......#..........+
##vvvvvvvv#*......#......___##
##................#.........##
##....*...........#.........##
##................#.........##
##................#.........##
##........^^^^^^^^#.........##
##........#########.........##
##..........................##
##..........................##
##....*................#######
##.....................#....##
##.................#####....##
##^^^^^^^^^........#........##
##############################
##############################

{
  "name": "Ping pong",
  "music": "musicWorld3",
  "baseLife": 1
}

