#########################++###
#########################..###
##...........#...........*..##
##...........#..............##
##..@........#..............##
##.###.......#.......*......##
##...........#..............##
##...........#..............##
##...........#..............##
##...........#......*.......##
##...........#..............##
##...........#..............##
##...........#..............##
##...........#....*....*....##
##......a....#..............##
##....[[[....#..............##
##...........#..*...........##
##...........#..............##
##..........................##
##.....................b....##
##############################
##############################

{
  "name": "Ever higher",
  "baseLife": 2
}

