##############################
##############################
##............vvvvvvvvvvvvvv##
##..........................##
##...####...................##
##.....##...................##
##.....##....................+
##.....##..^^^^^^^^^^^^^.....+
####...#######################
####...#######################
####.........?..........##.<##
####.........?..........##.<##
#######......?..........##.<##
#####################......<##
##............vvvvvvv#.....<##
##...................##....<##
##....................##...<##
##.........................<##
##.........................<##
##.@..^^^^^^^^^^^^.........<##
##############################
##############################

{
  "name": "Wall Jump",
  "baseLife": 3,
  "hint": "Press against a wall in the air and [JUMP]"
}

